time=50
### ### #####
#@# # #  # #
#*### #  # #
#     #  # #
# ### #  # #
# # # #  # #
### ### #####