  #########
###     $ #
#         #
#.   # @###
#########