title=Level 2;time=200
#########
#.      ##
#  @ #$  #
#    #   #
##########
