&&#########
&&#       #
###     $ #
#         #
#.     @###
#########