title=Level 1;time=3
  #########
  #      .#
###  $$$$ #
#.        .#
#.     @####
#########  #
        ####
